102,102,101,100,100,100,102,100,102,101,102,101,100,101,101,102
101,100,102,101,100,101,102,101,102,102,100,102,101,100,100,102
102,101,102,101,101,101,101,100,102,100,100,101,101,102,100,102
100,102,102,102,100,102,100,101,100,101,102,100,101,101,101,100
101,101,102,100,102,100,100,100,102,100,100,102,101,100,101,102
102,101,101,100,101,101,102,102,100,102,101,101,102,102,101,101
102,101,100,100,101,100,102,100,100,101,100,102,100,100,100,100
100,100,101,101,100,101,100,100,100,102,102,102,102,101,101,100
102,101,102,102,102,101,101,100,101,102,102,102,102,101,101,100
100,102,100,100,100,101,102,102,100,101,102,102,100,100,102,102
102,100,102,100,101,101,100,100,100,100,100,102,101,100,100,102
101,100,100,101,102,102,100,101,100,101,100,101,101,100,100,100
